R 960  640

NO textures/brick_no.xpm
SO textures/brick_so.xpm
WE textures/brick_we.xpm
EA textures/brick_ea.xpm
S textures/sprite1.xpm

F 169, 169, 169
C 5, 105, 200

                                                         111111111111111111111111111111111111111111
                                                        10000000000000000000000000000000000000000011
                                                        100000000000000000000002000000000000000000011
                                                        1000000000000000000000000000000000000000000011
              1111111  111111111111111111111            10002222200000000000000S00000000000000000000011
           1111100001  100000001000000001001            100000000000000000002000002000000000000000000011
        1111100000001  100000011110111111101            1000000000000000000222202222000000000000000000011
  1111111100000000001  10000000000011    101            10000000000000000002222022220000000000000000000011
  1000000000000000001  10000000000111   11011111111     100000000000000000022220222200000000000000000000011
  1100000000000000001  12000000000021   11000000021     1000000222222222220222022022022222222222200000000011
  1111111111111111111  11111100011111   11111111101     10000000000000000000000000000000000000000000000000011
                            10001               101     100000000000000000000000001000000000000000000000000011
  11111111111111111     111110001111111111111   101111  1000000000000000000000000111000000000000000000000000011
 111000000000000011    1100000000000000000001   100001  10000000000000000000000011 11000000000000000000000000011
  10000000000000001    1000000000000000000001   1100011 1000000000000000000000011   11000000000000000000000000011
  11000000000000011    1100000000010111110001   1000001 10000000000000000000000011 11000000000000000000000000011
  1000000000000001      1000000000101   10001   1000001 1000000000000000000000000111000000000000000000000000011
  11100000000000011111111000000000101   10001   11000011100000000000000000000000001000000000000000000000000011
   1111000000000000001000000000000001   10201  11100000000000000000220020000000022220000002222222000000000011
   1100000000000000000000000001111111   11111  1000111111000000000000000000000000000000000000000000000000011
   11111000001100000000000000000001            10001    100000000000000000000000000000000000000000000000011
 111000000000000000000000000001111111111111111110001    10000000022000222000002220000222002222000000000011
 111111000000000000000000000000000000000000000000001    1000000000000000000000000000000000000000000000011
     11111100000000000000000011111111111111111000001    100000000000000000000000000000000000000000000011
         1111110000000000111111            111111111    10000000000222222200000000000000000000000000011
             11111111111111                             1000000000000000000000000000000000000000000011
                                                        100000000002222000000000000000000000000000011
                                                        10000000000000000000000000000000000000000011
                                                        1111111111111111111111111111111111111111111 